111111111111111111111
140000000000000000001
101010101010101010101
100202020202020202021
101010101010101010101
100202020202020202021
101010101010101010101
100000000000000000061
111111111111111111111