11111111111111111111
10002000000400020001
11110110111011101111
10002000510000020001
11212121010101010101
11212121012121010121
12022020010200202001
10111111212111111121
12020100010001002001
11210101012111211121
10000100110201201001
12101112012102011121
10111111010111111101
11111111111111111111