11111111111111111111
14001110110110110051
10120002002002000101
12101110110110111101
10020002002002020021
11101011010101101011
10021010210120101201
11101201010101101011
16021020202000001011
10102101010110100201
12010101020100001101
10100101212010101021
12010102010110021101
10100101020002101001
10010101010110101101
10102020202000020121
10201110110110110001
10100202002002002101
16011011110111011061
11111111111111111111